"filename", "language", "Java", "comment", "blank", "total"
"c:\Users\rangerchenore\Desktop\CNT5106C_BitTorrent\P2P File Share\src\ActualMessageHandler.java", "Java", 17, 3, 7, 27
"c:\Users\rangerchenore\Desktop\CNT5106C_BitTorrent\P2P File Share\src\Bitfield.java", "Java", 61, 0, 20, 81
"c:\Users\rangerchenore\Desktop\CNT5106C_BitTorrent\P2P File Share\src\ChokeHandler.java", "Java", 34, 0, 8, 42
"c:\Users\rangerchenore\Desktop\CNT5106C_BitTorrent\P2P File Share\src\Client.java", "Java", 111, 9, 23, 143
"c:\Users\rangerchenore\Desktop\CNT5106C_BitTorrent\P2P File Share\src\ConfigReader.java", "Java", 23, 8, 10, 41
"c:\Users\rangerchenore\Desktop\CNT5106C_BitTorrent\P2P File Share\src\Handshake.java", "Java", 16, 1, 8, 25
"c:\Users\rangerchenore\Desktop\CNT5106C_BitTorrent\P2P File Share\src\Have.java", "Java", 25, 1, 8, 34
"c:\Users\rangerchenore\Desktop\CNT5106C_BitTorrent\P2P File Share\src\InterestHandler.java", "Java", 13, 3, 7, 23
"c:\Users\rangerchenore\Desktop\CNT5106C_BitTorrent\P2P File Share\src\Message.java", "Java", 26, 0, 6, 32
"c:\Users\rangerchenore\Desktop\CNT5106C_BitTorrent\P2P File Share\src\OptimisticChokeHandler.java", "Java", 12, 0, 5, 17
"c:\Users\rangerchenore\Desktop\CNT5106C_BitTorrent\P2P File Share\src\PeerProcess.java", "Java", 48, 1, 14, 63
"c:\Users\rangerchenore\Desktop\CNT5106C_BitTorrent\P2P File Share\src\Piece.java", "Java", 5, 0, 1, 6
"c:\Users\rangerchenore\Desktop\CNT5106C_BitTorrent\P2P File Share\src\Request.java", "Java", 2, 0, 2, 4
"c:\Users\rangerchenore\Desktop\CNT5106C_BitTorrent\P2P File Share\src\SampleClient.java", "Java", 69, 16, 7, 92
"c:\Users\rangerchenore\Desktop\CNT5106C_BitTorrent\P2P File Share\src\SampleServer.java", "Java", 77, 16, 10, 103
"c:\Users\rangerchenore\Desktop\CNT5106C_BitTorrent\P2P File Share\src\Server.java", "Java", 97, 17, 17, 131
"Total", "-", 636, 75, 153, 864