"filename", "language", "Java", "comment", "blank", "total"
"c:\Users\r2che\Desktop\CNT5106C_BitTorrent\P2P File Share\src\ActualMessageHandler.java", "Java", 24, 1, 5, 30
"c:\Users\r2che\Desktop\CNT5106C_BitTorrent\P2P File Share\src\Bitfield.java", "Java", 74, 3, 23, 100
"c:\Users\r2che\Desktop\CNT5106C_BitTorrent\P2P File Share\src\ChokeHandler.java", "Java", 41, 0, 12, 53
"c:\Users\r2che\Desktop\CNT5106C_BitTorrent\P2P File Share\src\Client.java", "Java", 119, 5, 20, 144
"c:\Users\r2che\Desktop\CNT5106C_BitTorrent\P2P File Share\src\ClientOLD.java", "Java", 131, 9, 28, 168
"c:\Users\r2che\Desktop\CNT5106C_BitTorrent\P2P File Share\src\ConfigReader.java", "Java", 178, 17, 19, 214
"c:\Users\r2che\Desktop\CNT5106C_BitTorrent\P2P File Share\src\FileHandler.java", "Java", 13, 0, 5, 18
"c:\Users\r2che\Desktop\CNT5106C_BitTorrent\P2P File Share\src\Handshake.java", "Java", 22, 1, 7, 30
"c:\Users\r2che\Desktop\CNT5106C_BitTorrent\P2P File Share\src\HaveHandler.java", "Java", 29, 2, 9, 40
"c:\Users\r2che\Desktop\CNT5106C_BitTorrent\P2P File Share\src\InterestHandler.java", "Java", 17, 3, 7, 27
"c:\Users\r2che\Desktop\CNT5106C_BitTorrent\P2P File Share\src\Message.java", "Java", 26, 0, 6, 32
"c:\Users\r2che\Desktop\CNT5106C_BitTorrent\P2P File Share\src\OptimisticChokeHandler.java", "Java", 12, 0, 5, 17
"c:\Users\r2che\Desktop\CNT5106C_BitTorrent\P2P File Share\src\PeerProcess.java", "Java", 61, 0, 14, 75
"c:\Users\r2che\Desktop\CNT5106C_BitTorrent\P2P File Share\src\PieceHandler.java", "Java", 16, 0, 4, 20
"c:\Users\r2che\Desktop\CNT5106C_BitTorrent\P2P File Share\src\RequestHandler.java", "Java", 8, 0, 2, 10
"c:\Users\r2che\Desktop\CNT5106C_BitTorrent\P2P File Share\src\SampleClient.java", "Java", 69, 16, 7, 92
"c:\Users\r2che\Desktop\CNT5106C_BitTorrent\P2P File Share\src\SampleServer.java", "Java", 77, 16, 10, 103
"c:\Users\r2che\Desktop\CNT5106C_BitTorrent\P2P File Share\src\Server.java", "Java", 23, 0, 4, 27
"c:\Users\r2che\Desktop\CNT5106C_BitTorrent\P2P File Share\src\ServerOLD.java", "Java", 109, 17, 17, 143
"c:\Users\r2che\Desktop\CNT5106C_BitTorrent\P2P File Share\src\StartRemotePeers.java", "Java", 87, 31, 33, 151
"Total", "-", 1136, 121, 237, 1494